00111000000000000011
00011100000000000111
00011100000000001110
00111000000000011100
00111000000001111000
00011100001111100000
00001111111111100000
00000011111000000000
00000000111000000000
00000000111000000000
00000000111000000000
00000000111000000000
00000000111000000000
00000000111100000000
00000000001110000000
00000000011111000000
00000000111011111111
00000111110001111111
00001111100000000000
00001100000000000000
