20
20
00111000000000000001
00111000000000000011
00111000000000000111
00111000000000001110
00111100000000111100
00011110001111111000
00001111111111110000
00000011111100000000
00000000111000000000
00000000111000000000
00000000111000000000
00000000111000000000
00000000111000000000
00000000011100000000
00000000011110000000
00000000011111000000
00000000111011111111
00000111110001111111
00001111100000000000
00001100000000000000
