20
10
01110000000000000000
01110000000000000000
01111000000000000000
00111100000000000000
00011111111111111111
00001111111111111111
00000111111111111111
00000000000000000000
00000000000000000000
00000000000000000000
